WE ./textures/metal.xpm
NO ./textures/mur_moche.xpm
SO ./textures/red_bricks.xpm
EA ./textures/wood.xpm

F 0,100,0
C 0,0,100

        1111111111111111111111111
        1000000000110000000000001
        1011000001110000000000001
        1000100000000000000000001
111111111011000001110000000000001
100000000011000001110111111111111
11110111111111011100000030001
11110111111111011101310010001
11000000110101011100000012221
10000000000000001101310010001
10000000000000001101010010001
11000001110101011111011110N0111
11110111 1110101 101111010001
11111111 1111111 111111111111