WE ./textures/lol.xpm
NO ./textures/lol.xpm
SO ./textures/lol.xpm
EA ./textures/lol.xpm

F 220,100,0
C 225,30,150

11111111111111111   11111
10000000000000001   10001
10000000000000001   10001
1000000000000000111110001
1000000000000000000000001
1000000000000000000000001
1000000000000000000000001
1000000000000000000000001
1000000000000000000000001
1000000000000000000000001
100000022222222220000W001
1000000222222222200000001
1000000222222222200000001
1000000222222222200000001
1000000222222222200000001
1000000000000000000000001
1000000000000000000000001
1000000000000000000000001
1000000000000000000000001
11111000000000000000000011111
    1000000000000000000000001
11111000000000000000000011111
1000000000000000000000001
1000000000000000000000001
1111111111111111111111111