WE ./textures/metal.xpm
NO ./textures/mur_moche.xpm
SO ./textures/red_bricks.xpm
EA ./textures/wood.xpm

F 0,100,0
C 0,0,100

    1         1   111111 111
11110111111111011100000030001
11110111111111011101310010001
1100000011N101011100000012221
10000000000000001101310010001
11111111111111111111111111111