WE ./textures/metal.xpm
NO ./textures/mur_moche.xpm
SO ./textures/red_bricks.xpm
EA ./textures/wood.xpm

F 0,100,0
C 0,0,100

1111
11011
1W001
110111
 1111