111111
1N0121
101001
110201
111111