111111
100121
101001
1102N1
111111