WE ./textures/metal.xpm
NO ./textures/mur_moche.xpm
SO ./textures/red_bricks.xpm
EA ./textures/wood.xpm

                             1111111111111
     111111                  1000000000001
     100001      11111111111110000000000011111
     1022011     10000000000010000000020010001
     1022011     10000000000000000000000000001
     1000001     10000000000010000000000010001
     11111311111 10001111111110000000000011111
     10000000001 10001       1000000000001
     1000000000111000111     1111113111111
     1000000000100000001         10001
     1000000000000000001         10001
     1000000000100000001         10001
111111000000000111111111         10001
1000110000000001                 10001
1000111111311111            111111000111
10001   10001               110000000001
11311   10001               100111000111
1000111110001               1001110001
1000100010001               1001110001
1000000010001               1111110001
1000100010001                    10001
1000111111311111                1113111               1111111111
1000110000000001           111111000001111111         1000000001
1000110000000001           100000000000000011         1000000001
1000110000000001           1000000000000000111111111111000000001
1000010000000001           1000000000000000010000000001000000001
1000000000000001           1000000000000000030000000000000020001
1000010000000001           1000000000002000010000000001000000001
1000110020000001           1000000000000000111100001111000000001
1000110000000001           1000000000000000111110011  1000000001
1000110000000001           11111100000111111   1001   1000000001
1000111111311111                1113111        1001   1110110111
1000111110001                    10001         1001     111111
1000111110001                    10001         1001
1000100010001                    10001         1001 111111111
1000302010001                    10001         100111010101011
1000100010001                    10001         100010000000001
1000111110001                    10001         100000000000001
10001111100011111111111111       10001         100010000200001
1000000000000000010000000111     10001         111111010101011
1000000000000000030000200001     10001              111111111
1000000000000000010000000111     10001
11111111111111111101111111       10001
         111001100001       111111131111111
         103001001111       100001000100001
         11100000111        100000000000001
           1110111          100001000100001
            1001            100001000100001
            1011            111111000111111
            1111            100001000100001
                            10E000020000001
                            100001000100001
                            111111000111111
                            100000000000001
                            100000000000001
                            100000000000001
                            111111111111111